         B           BB
        BB           BBB
BBBBBBBBBB           BBBBBBBBBB
BBBBBBBBBB     B     BBBBBBBBBB
BBBBBBBBBBS   BBB   OBBBBBBBBBB
BBBBBBBBBBBBBBBBBBBBBBBBBBBBBBB
BBBBBBBBBBBBBBBBBBBBBBBBBBBBBBB
BBBBBBBBBBBBBBBBBBBBBBBBBBBBBBB
BBBBBBBBBBBBBBBBBBBBBBBBBBBBBBB
BBBBBBBBBBBBBBBBBBBBBBBBBBBBBBB