                 B    BB
         B       B    BB
         B       B    BBBB
        BBS      B   PBBBBBB
BBBBBBBBBBBBB    B    BBBBBBBBBB
BBBBBBBBBB     B   B  BBBBBBBBBB
BBBBBBBBBBO    B   B OBBBBBBBBBB
BBBBBBBBBBBBBBBBBBBBBBBBBBBBBBBB
BBBBBBBBBBBBBBBBBBBBBBBBBBBBBBBB
BBBBBBBBBBBBBBBBBBBBBBBBBBBBBBBB
BBBBBBBBBBBBBBBBBBBBBBBBBBBBBBBB
BBBBBBBBBBBBBBBBBBBBBBBBBBBBBBBB