                     B B
         B           BBB
         B           BBBB
        BB          OBBBBBB
BBBBBBBBBB          BBBBBBBBBBB
BBBBBBBBBB   BB     BBBBBBBBBBB
BBBBBBBBBBS  BO     BBBBBBBBBBB
BBBBBBBBBBBBBBBBBBBBBBBBBBBBBBB
BBBBBBBBBBBBBBBBBBBBBBBBBBBBBBB
BBBBBBBBBBBBBBBBBBBBBBBBBBBBBBB
BBBBBBBBBBBBBBBBBBBBBBBBBBBBBBB
BBBBBBBBBBBBBBBBBBBBBBBBBBBBBBB