         B       B            BB
         B       B          B BB
         B     O B          BPBB
        BB     B            B BBB
BBBBBBBBBB     B    B         BBBBBBBBBBB
BBBBBBBBBBS  O B    B         BBBBBBBBBBB
BBBBBBBBBBBBBB B   OBO       OBBBBBBBBBBB
BBBBBBBBBBBBBBBBBBBBBBBBBBBBBBBBBBBBBBBBB
BBBBBBBBBBBBBBBBBBBBBBBBBBBBBBBBBBBBBBBBB
BBBBBBBBBBBBBBBBBBBBBBBBBBBBBBBBBBBBBBBBB
BBBBBBBBBBBBBBBBBBBBBBBBBBBBBBBBBBBBBBBBB
BBBBBBBBBBBBBBBBBBBBBBBBBBBBBBBBBBBBBBBBB